W - - W - W W W - - W
- - - - - - - - - - W
- - W - - - - W - - -
W - - W B - - - - - W
- - - - - W - - - W -
- - - - - - - - - W -
- E - W - W - - - - -
W - W - W - - W W - -
- - - - - - - W - - -
