- - - - - - - - W W - W W - -
- W - W W W - - - W - - - - -
- - - W - - - - - - - - - W -
- - - - - W W - - W - - - - -
- W W W - - - - W W - - - W -
- - - - - W - - - - - W - - -
- - B W - - - - - - - E - - -
W - - W W - - - - - - - - - W
- - - - - - W - - - W - - - -
- - - W - - - - - - - - - W W
