W - - W -
- - - - E
- - W - -
- B - - W
- W W W W